ARD	Antimicrobial
ldt	beta-lactam
aac2	aminoglycosides
aac3_1	aminoglycosides
aac3_2	aminoglycosides
aac6	aminoglycosides
ant	aminoglycosides
aph	aminoglycosides
blaa	beta-lactam
blab1	beta-lactam
blab3	beta-lactam
blac	beta-lactam
blad	beta-lactam
dfra	trimethoprim
erm	macrolides
fos	fosfomycin
qnr	quinolones
sul	sulphonamides
tetM	tetracyclines
tetX	tetracyclines
van	glycopeptides
serpin	inflammation
rnam	aminoglycosides
mcr	colistin
